..........
..........
..........
2345234523
1111111111
1111111111
----------
##########
