..........
..........
..........
..........
..........
2345234523
----------
##########
