########
#......#
#..H...#
#......#
#...D..#
########
