..........
..........
..........
..........
.....H..F.
----------
##########
